{
    "name":"default_map",
    "pos_x": 1,
    "pos_y": 3,
    "integerMapData":[
    [1,0,1,0,1,0,1],
    [1,1,1,0,1,1,1],
    [0,1,0,0,0,1,0],
    [1,1,1,1,1,1,1],
    [1,0,0,1,0,0,1],
    [0,0,1,1,1,0,0],
    [1,0,0,1,0,0,1],
    [1,1,1,1,1,1,1]
    ],
    "integerItemData":[
    [1,0,1,0,1,0,1],
    [1,1,1,0,1,1,1],
    [0,1,0,0,0,1,0],
    [1,1,1,3,1,1,1],
    [2,0,0,1,0,0,1],
    [0,0,1,1,2,0,0],
    [1,0,0,1,0,0,1],
    [1,1,1,1,1,1,1]
    ]
}