{
  "name":"map2",
  "pos_x": 1,
  "pos_y": 3,
  "integerMapData":[
    [0,0,1,0,1,0,0],
    [0,1,1,0,1,1,0],
    [0,1,0,0,0,1,0],
    [0,1,1,1,1,1,0],
    [0,0,0,1,0,0,0],
    [0,0,1,1,1,0,0],
    [0,0,0,1,0,0,0],
    [0,1,1,1,1,1,0]
  ],
  "integerItemData":[
    [0,0,2,0,1,0,0],
    [0,1,1,0,1,1,0],
    [0,1,0,0,0,1,0],
    [0,1,1,1,1,1,0],
    [0,0,0,2,0,0,0],
    [0,0,1,1,1,0,0],
    [0,0,0,1,0,0,0],
    [0,1,2,1,1,1,0]
  ]
}